///////////////////////////////
/  H                          /
/  HH                         /
/   EEE                       /
/   EEE   H                   /
/   EEE                       /
/              HH             /
S            H                D
/                             /
/                             /
/                             /
/                     HH     J/
/   H        H        HH      /
/       H                     /
///////////////////////////////