//////////////////////////////////
///               H           ////
//  H            HH           ////
/  HH          HH             ////
/      HHH                    ////
/              HH        HHH  ////
GJ                        HH  ////
/             EE              ////
/             EEE             ////
/         H     EE             ///
/       HHH                     //
//         HH            EE     //
///          H             E   ///
//////////////////////////////////