///////////////////////////////
/  H                          /
/  HH                         /
/   EEE                       /
/   EEE   H                   /
/   EEE                       /
/              HH             /
GJ           H                D
/                             /
/                             /
/                             /
/                     HH      /
/   H        H        HH      /
/       H                     /
///////////////////////////////