///////////////////////////////
/  H                          /
/  HH                         /
/   EEE                       /
/   EEE   H                   /
/   EEE                       /
/              HH             /
/            H                /
/                             /
/                             /
/                             /
/                            J/
/   H        H                /
/       H                     /
///////////////////////////////